"common_name"	"latin_binomial"
PRUNUS SPINOSA	PRUNUS SPINOSA
PHYTOLACCA AMERICANA	PHYTOLACCA AMERICANA
SMILAX PSEUDOCHINA	SMILAX PSEUDOCHINA
HARUNGANA MADAGASCARIENSIS	HARUNGANA MADAGASCARIENSIS
QUERCUS LOBATA	QUERCUS LOBATA
JATROPHA CURCAS	JATROPHA CURCAS
SOLANUM ACULEASTRUM	SOLANUM ACULEASTRUM
COMMIPHORA MUKUL	GUGGUL
ORIGANUM MAJORANA	ORIGANUM MAJORANA
PTERIDIUM AQUILINUM	PTERIDIUM AQUILINUM
MOMORDICA CHARANTIA	MOMORDICA CHARANTIA
ILEX PARAGUARIENSIS	ILEX PARAGUARIENSIS
ERYNGIUM FOETIDUM	ERYNGIUM FOETIDUM
CAPPARIS SPINOSA	CAPPARIS SPINOSA
SALVIA MILTIORRHIZA	SALVIA MILTIORRHIZA
LIQUIDAMBAR STYRACIFLUA	LIQUIDAMBAR STYRACIFLUA
ILEX OPACA	ILEX OPACA
MALVA SYLVESTRIS	MALVA SYLVESTRIS
PAPAVER RHOEAS	PAPAVER RHOEAS
COLLINSIA PARVIFLORA	COLLINSIA PARVIFLORA
LENS CULINARIS	LENS CULINARIS
CARPINUS CAROLINIANA	CARPINUS CAROLINIANA
ANCHUSA OFFICINALIS	ANCHUSA OFFICINALIS
SANGUINARIA CANADENSIS	SANGUINARIA CANADENSIS
HORSETAIL	HORSETAIL
ELDERBERRY	ELDERBERRY
BACTRIS MAJOR	BACTRIS MAJOR
LEONURUS CARDIACA	LEONURUS CARDIACA
SOLIDAGO SIMPLEX	SOLIDAGO SIMPLEX
RUBUS CANADENSIS	RUBUS CANADENSIS
DAPHNE SERICEA	DAPHNE SERICEA
ANGELICA PINNATA	ANGELICA PINNATA
SALIX BABYLONICA	SALIX BABYLONICA
HEUCHERA CYLINDRICA	HEUCHERA CYLINDRICA
CLINOPODIUM NEPETA	CLINOPODIUM NEPETA
TRIFOLIUM PRATENSE	TRIFOLIUM PRATENSE
URTICA DIOICA	URTICA DIOICA
CASTANEA PUMILA	CASTANEA PUMILA
SERENOA REPENS	SERENOA REPENS
ARISTOLOCHIA SERICEA	ARISTOLOCHIA SERICEA
OCIMUM TENUIFLORUM	OCIMUM TENUIFLORUM
TAMARINDUS INDICA	TAMARINDUS INDICA
LICORICE	GLYCYRRHIZA INFLATA
FUCUS DISTICHUS	FUCUS DISTICHUS
PIRIQUETA RACEMOSA	PIRIQUETA RACEMOSA
AFROLICANIA ELAEOSPERMA	AFROLICANIA ELAEOSPERMA
DIPLOTAXIS ERUCOIDES	DIPLOTAXIS ERUCOIDES
HYLOTELEPHIUM TELEPHIUM	HYLOTELEPHIUM TELEPHIUM
SMILAX AURICULATA	SMILAX AURICULATA
SALIX PYRIFOLIA	SALIX PYRIFOLIA
HELMINTHOTHECA ECHIOIDES	HELMINTHOTHECA ECHIOIDES
MORELLA CERIFERA	MORELLA CERIFERA
CINNAMOMUM CAMPHORA	CINNAMOMUM CAMPHORA
BERBERIS ARISTATA	BERBERIS ARISTATA
WATSONIA DENSIFLORA	WATSONIA DENSIFLORA
LYCIUM PALLIDUM	LYCIUM PALLIDUM
PLUCHEA INDICA	PLUCHEA INDICA
QUERCUS CERRIS	QUERCUS CERRIS
SOLANUM AMERICANUM	SOLANUM AMERICANUM
CITRUS SINENSIS	CITRUS SINENSIS
JUNIPERUS OXYCEDRUS	JUNIPERUS OXYCEDRUS
AGELAEA PENTAGYNA	AGELAEA PENTAGYNA
RHUS CORIARIA	RHUS CORIARIA
LYCIUM BARBARUM	LYCIUM BARBARUM
THYMUS VULGARIS	THYMUS VULGARIS
BACOPA MONNIERI	BACOPA MONNIERI
EPIMEDIUM PUBESCENS	EPIMEDIUM PUBESCENS
ASPHODELINE LUTEA	ASPHODELINE LUTEA
EQUISETUM HYEMALE	HORSETAIL
ALBIZIA JULIBRISSIN	ALBIZIA JULIBRISSIN
CORDYCEPS	TOONA SINENSIS
ATRACTYLODES LANCEA	ATRACTYLODES LANCEA
FAGUS GRANDIFOLIA	FAGUS GRANDIFOLIA
SMILAX GLABRA	SMILAX GLABRA
CEPHALANTHUS OCCIDENTALIS	CEPHALANTHUS OCCIDENTALIS
VERBASCUM THAPSUS	VERBASCUM THAPSUS
LACHNANTHES CAROLINIANA	LACHNANTHES CAROLINIANA
PISTACIA TEREBINTHUS	PISTACIA TEREBINTHUS
SMILAX BINCHUANENSIS	SMILAX BINCHUANENSIS
EPIMEDIUM GRANDIFLORUM	EPIMEDIUM GRANDIFLORUM
CHIMAPHILA UMBELLATA	CHIMAPHILA UMBELLATA
DAPHNE LAUREOLA	DAPHNE LAUREOLA
SCHOENOPLECTUS TABERNAEMONTANI	SCHOENOPLECTUS TABERNAEMONTANI
SMILAX LAURIFOLIA	SMILAX LAURIFOLIA
ANDROPOGON GLOMERATUS	ANDROPOGON GLOMERATUS
QUERCUS MARILANDICA	QUERCUS MARILANDICA
NOTOPTERYGIUM INCISUM	NOTOPTERYGIUM INCISUM
LIRIODENDRON TULIPIFERA	LIRIODENDRON TULIPIFERA
SCHINUS TEREBINTHIFOLIA	SCHINUS TEREBINTHIFOLIA
BOLBOSCHOENUS FLUVIATILIS	BOLBOSCHOENUS FLUVIATILIS
EUPHORBIA LACEI	EUPHORBIA LACEI
ASCLEPIAS STELLIFERA	ASCLEPIAS STELLIFERA
THUNBERGIA LAURIFOLIA	THUNBERGIA LAURIFOLIA
HIBISCUS MOSCHEUTOS	HIBISCUS MOSCHEUTOS
ECBALLIUM ELATERIUM	ECBALLIUM ELATERIUM
HYSSOPUS OFFICINALIS	HYSSOPUS OFFICINALIS
ILEX MUCRONATA	ILEX MUCRONATA
SAUSSUREA INVOLUCRATA	SAUSSUREA INVOLUCRATA
RHUS COPALLINUM	RHUS COPALLINUM
SWERTIA PSEUDOCHINENSIS	SWERTIA PSEUDOCHINENSIS
NICOTIANA GLAUCA	NICOTIANA GLAUCA
DACTYLORHIZA INCARNATA	DACTYLORHIZA INCARNATA
AFROHYBANTHUS ENNEASPERMUS	AFROHYBANTHUS ENNEASPERMUS
OLEA EUROPAEA	OLEA EUROPAEA
RUTA CHALEPENSIS	RUTA CHALEPENSIS
TEPHROSIA VIRGINIANA	TEPHROSIA VIRGINIANA
HYPERICUM TRIQUETRIFOLIUM	HYPERICUM TRIQUETRIFOLIUM
VICIA SATIVA	VICIA SATIVA
PALIURUS SPINA-CHRISTI	PALIURUS SPINA-CHRISTI
CURCUMA ZEDOARIA	CURCUMA ZEDOARIA
ULMUS MINOR	ULMUS MINOR
ERICA MULTIFLORA	ERICA MULTIFLORA
EUPHORBIA ANTISYPHILITICA	EUPHORBIA ANTISYPHILITICA
SPARTIUM JUNCEUM	SPARTIUM JUNCEUM
VIBURNUM OPULUS	VIBURNUM OPULUS
CLUSIA FLAVA	CLUSIA FLAVA
MIMOSA PUDICA	MIMOSA PUDICA
ANEMOPSIS CALIFORNICA	ANEMOPSIS CALIFORNICA
SAPOSHNIKOVIA DIVARICATA	SAPOSHNIKOVIA DIVARICATA
BAUHINIA LONGIFOLIA	BAUHINIA LONGIFOLIA
CITRULLUS ECIRRHOSUS	CITRULLUS ECIRRHOSUS
ILEX VOMITORIA	ILEX VOMITORIA
DIOSCOREA PRAEHENSILIS	DIOSCOREA PRAEHENSILIS
CYANTHILLIUM CINEREUM	CYANTHILLIUM CINEREUM
ACTAEA RACEMOSA	ACTAEA RACEMOSA
URARIA CRINITA	URARIA CRINITA
INONOTUS OBLIQUUS	INONOTUS OBLIQUUS
SENNA ITALICA	SENNA ITALICA
TANACETUM PARTHENIUM	TANACETUM PARTHENIUM
ULMUS AMERICANA	ULMUS AMERICANA
SENNA	SENNA ALEXANDRINA
COPTIS	COPTIS CHINENSIS
HYPERICUM GENTIANOIDES	HYPERICUM GENTIANOIDES
MAMMEA AMERICANA	MAMMEA AMERICANA
MAGNOLIA OFFICINALIS	MAGNOLIA OFFICINALIS
OENANTHE AQUATICA	OENANTHE AQUATICA
ACHILLEA MILLEFOLIUM	ACHILLEA MILLEFOLIUM
QUERCUS NIGRA	QUERCUS NIGRA
ALOCASIA MACRORRHIZOS	ALOCASIA MACRORRHIZOS
GLYCYRRHIZA GLABRA	LICORICE
DITRYSINIA FRUTICOSA	DITRYSINIA FRUTICOSA
GUGGUL	GUGGUL
TUSSILAGO FARFARA	TUSSILAGO FARFARA
SAMBUCUS NIGRA	SAMBUCUS NIGRA
EQUISETUM ARVENSE	EQUISETUM ARVENSE
TABERNAEMONTANA DIVARICATA	TABERNAEMONTANA DIVARICATA
ATRIPLEX NUMMULARIA	ATRIPLEX NUMMULARIA
AFRAMOMUM ANGUSTIFOLIUM	AFRAMOMUM ANGUSTIFOLIUM
PERSICARIA PUNCTATA	PERSICARIA PUNCTATA
CORDYCEPS	CORDYCEPS
CHRYSOJASMINUM FRUTICANS	CHRYSOJASMINUM FRUTICANS
POLYGALA AMARA	POLYGALA AMARA
HYGROPHILA COSTATA	HYGROPHILA COSTATA
JUNCUS EFFUSUS	JUNCUS EFFUSUS
BERBERIS AQUIFOLIUM	BERBERIS AQUIFOLIUM
GENTIANA LUTEA	GENTIANA LUTEA
MELIA AZEDARACH	MELIA AZEDARACH
BLACK PEPPER	PIPER NIGRUM
ULMUS RUBRA	ULMUS RUBRA
SCOLYMUS HISPANICUS	SCOLYMUS HISPANICUS
ARDISIA CRENATA	ARDISIA CRENATA
ARALIA SPINOSA	ARALIA SPINOSA
LIMNOPHYTON OBTUSIFOLIUM	LIMNOPHYTON OBTUSIFOLIUM
FICUS CARICA	FICUS CARICA
GLAUCIUM FLAVUM	GLAUCIUM FLAVUM
CLITORIA MARIANA	CLITORIA MARIANA
THONNINGIA SANGUINEA	THONNINGIA SANGUINEA
ILEX CRENATA	ILEX CRENATA
MORUS RUBRA	MORUS RUBRA
CORIANDRUM SATIVUM	CORIANDRUM SATIVUM
PIPER SARMENTOSUM	PIPER SARMENTOSUM
ALPINIA OFFICINARUM	ALPINIA OFFICINARUM
HIPPOPHAE SALICIFOLIA	HIPPOPHAE SALICIFOLIA
GERANIUM WILFORDII	GERANIUM WILFORDII
COCCINIA HIRTELLA	COCCINIA HIRTELLA
INDIGOFERA HIRSUTA	INDIGOFERA HIRSUTA
OXALIS ACETOSELLA	OXALIS ACETOSELLA
SISYMBRIUM OFFICINALE	SISYMBRIUM OFFICINALE
CROTALARIA PALLIDA	CROTALARIA PALLIDA
CENTRANTHUS RUBER	CENTRANTHUS RUBER
GLADIOLUS DALENII	GLADIOLUS DALENII
NUPHAR LUTEA	NUPHAR LUTEA
EUCALYPTUS ODORATA	EUCALYPTUS ODORATA
AESCULUS PAVIA	AESCULUS PAVIA
CUPHEA CARTHAGENENSIS	CUPHEA CARTHAGENENSIS
TILLANDSIA USNEOIDES	TILLANDSIA USNEOIDES
BRASSICA RAPA	BRASSICA RAPA
LACTUCA INDICA	LACTUCA INDICA
IRIS VIRGINICA	IRIS VIRGINICA
QUERCUS ALBA	QUERCUS ALBA
SILENE LATIFOLIA	SILENE LATIFOLIA
ERUCA VESICARIA	ERUCA VESICARIA
FRAXINUS AMERICANA	FRAXINUS AMERICANA
PICEA ABIES	PICEA ABIES
SCROPHULARIA UMBROSA	SCROPHULARIA UMBROSA
ARTEMISIA HERBA-ALBA	ARTEMISIA HERBA-ALBA
DELONIX REGIA	DELONIX REGIA
GARCINIA	GARCINIA GERRARDII
TRIPSACUM DACTYLOIDES	TRIPSACUM DACTYLOIDES
DESMODIUM GLUTINOSUM	DESMODIUM GLUTINOSUM
SALVIA VERBENACA	SALVIA VERBENACA
PRUNUS PERSICA	PRUNUS PERSICA
ZANTHOXYLUM ARMATUM	ZANTHOXYLUM ARMATUM
ACER PICTUM	ACER PICTUM
STYELA CLAVA	STYELA CLAVA
BERBERIS ARISTATA	BARBERRY
CROTALARIA JUNCEA	CROTALARIA JUNCEA
SENECIO FISTULOSUS	SENECIO FISTULOSUS
SALIX NIGRA	SALIX NIGRA
ECHINACEA PURPUREA	ECHINACEA PURPUREA
HELICHRYSUM GYMNOCEPHALUM	HELICHRYSUM GYMNOCEPHALUM
EUPATORIUM FORTUNEI	EUPATORIUM FORTUNEI
DROSERA INTERMEDIA	DROSERA INTERMEDIA
CENTAUREA BENEDICTA	CENTAUREA BENEDICTA
RHEUM ACUMINATUM	RHEUM ACUMINATUM
FICUS SUR	FICUS SUR
CORYDALIS BUNGEANA	CORYDALIS BUNGEANA
QUERCUS FALCATA	QUERCUS FALCATA
TAMARIX CHINENSIS	TAMARIX CHINENSIS
SAPONARIA OFFICINALIS	SAPONARIA OFFICINALIS
BUPLEURUM CHINENSE	BUPLEURUM CHINENSE
SWERTIA LEDUCII	SWERTIA LEDUCII
ROBINIA PSEUDOACACIA	ROBINIA PSEUDOACACIA
BARBERRY	BARBERRY
COMBRETUM MOLLE	COMBRETUM MOLLE
BLACK PEPPER	BLACK PEPPER
SENNA	SENNA
AMORPHA FRUTICOSA	AMORPHA FRUTICOSA
PSEUDOGNAPHALIUM OBTUSIFOLIUM	PSEUDOGNAPHALIUM OBTUSIFOLIUM
VERBASCUM SINUATUM	VERBASCUM SINUATUM
SASSAFRAS ALBIDUM	SASSAFRAS ALBIDUM
ROSA CANINA	ROSA CANINA
ONONIS SPINOSA	ONONIS SPINOSA
CELTIS GOMPHOPHYLLA	CELTIS GOMPHOPHYLLA
QUERCUS MACROCARPA	QUERCUS MACROCARPA
EUPATORIUM CAPILLIFOLIUM	EUPATORIUM CAPILLIFOLIUM
PRUNUS CORNUTA	PRUNUS CORNUTA
THYMBRA CAPITATA	THYMBRA CAPITATA
LICORICE	GLYCYRRHIZA GLABRA
COPTIS CHINENSIS	COPTIS
URENA LOBATA	URENA LOBATA
GARCINIA GERRARDII	GARCINIA
MIKANIA BANISTERIAE	MIKANIA BANISTERIAE
AMOMUM VILLOSUM	AMOMUM VILLOSUM
PHYLLANTHUS AMARUS	PHYLLANTHUS AMARUS
CELTIS LAEVIGATA	CELTIS LAEVIGATA
CINNAMOMUM BURMANNI	CINNAMOMUM BURMANNI
ASTRAGALUS HUMISTRATUS	ASTRAGALUS HUMISTRATUS
REYNOUTRIA MULTIFLORA	REYNOUTRIA MULTIFLORA
ALBATRELLUS CONFLUENS	ALBATRELLUS CONFLUENS
PRUNUS ANGUSTIFOLIA	PRUNUS ANGUSTIFOLIA
LICORICE	GLYCYRRHIZA URALENSIS
CURCUMA LONGA	CURCUMA LONGA
MYRTUS COMMUNIS	MYRTUS COMMUNIS
RUMEX VENOSUS	RUMEX VENOSUS
DIGITALIS FERRUGINEA	DIGITALIS FERRUGINEA
CENTROSEMA VIRGINIANUM	CENTROSEMA VIRGINIANUM
PARTHENOCISSUS QUINQUEFOLIA	PARTHENOCISSUS QUINQUEFOLIA
FOMES FOMENTARIUS	FOMES FOMENTARIUS
CLEMATIS VILLOSA	CLEMATIS VILLOSA
BORAGO OFFICINALIS	BORAGO OFFICINALIS
LEPIDIUM VIRGINICUM	LEPIDIUM VIRGINICUM
ERYTHRINA LYSISTEMON	ERYTHRINA LYSISTEMON
EUGENIA BIFLORA	EUGENIA BIFLORA
CROTON STELLATOPILOSUS	CROTON STELLATOPILOSUS
IPOMOEA PANDURATA	IPOMOEA PANDURATA
CYPERUS ROTUNDUS	CYPERUS ROTUNDUS
NERIUM OLEANDER	NERIUM OLEANDER
CARCHARHINUS LEUCAS	CARCHARHINUS LEUCAS
IMPATIENS PARVIFLORA	IMPATIENS PARVIFLORA
SENNA OBTUSIFOLIA	SENNA OBTUSIFOLIA
FILIPENDULA ULMARIA	FILIPENDULA ULMARIA
TRIFOLIUM REPENS	TRIFOLIUM REPENS
PAPAVER SOMNIFERUM	PAPAVER SOMNIFERUM
SALVIA TOMENTOSA	SALVIA TOMENTOSA
RUBUS LACINIATUS	RUBUS LACINIATUS
AZADIRACHTA INDICA	AZADIRACHTA INDICA
PSEUDARTHRIA HOOKERI	PSEUDARTHRIA HOOKERI
MARKHAMIA LUTEA	MARKHAMIA LUTEA
BERBERIS LYCIUM	BERBERIS LYCIUM
PSEUDOGNAPHALIUM STRAMINEUM	PSEUDOGNAPHALIUM STRAMINEUM
CEDRUS LIBANI	CEDRUS LIBANI
ANTHYLLIS VULNERARIA	ANTHYLLIS VULNERARIA
ASCLEPIAS CURASSAVICA	ASCLEPIAS CURASSAVICA
CRATAEGUS SONGARICA	CRATAEGUS SONGARICA
QUERCUS VIRGINIANA	QUERCUS VIRGINIANA
PSORALEA PINNATA	PSORALEA PINNATA
INULA HELENIUM	INULA HELENIUM
MORINDA CITRIFOLIA	MORINDA CITRIFOLIA
PHYSALIS VIRGINIANA	PHYSALIS VIRGINIANA
VITEX DONIANA	VITEX DONIANA
JUGLANS NIGRA	JUGLANS NIGRA
CORDYCEPS MILITARIS	CORDYCEPS MILITARIS
ROSA DAMASCENA	ROSA DAMASCENA
SATUREJA MONTANA	SATUREJA MONTANA
DIGITARIA INSULARIS	DIGITARIA INSULARIS
SMYRNIUM OLUSATRUM	SMYRNIUM OLUSATRUM
COLA NITIDA	COLA NITIDA
DRYOBALANOPS AROMATICA	DRYOBALANOPS AROMATICA
RIVINA HUMILIS	RIVINA HUMILIS
NEPETA CATARIA	NEPETA CATARIA
ERECHTITES HIERACIFOLIUS	ERECHTITES HIERACIFOLIUS
GYMNEMA LATIFOLIUM	GYMNEMA LATIFOLIUM
SONCHUS OLERACEUS	SONCHUS OLERACEUS
SAURURUS CERNUUS	SAURURUS CERNUUS
SALVIA PRATENSIS	SALVIA PRATENSIS
PINUS KESIYA	PINUS KESIYA
MITCHELLA REPENS	MITCHELLA REPENS
YUCCA FILAMENTOSA	YUCCA FILAMENTOSA
RANUNCULUS ACRIS	RANUNCULUS ACRIS
SOLANUM ANGUIVI	SOLANUM ANGUIVI
RUBUS ALLEGHENIENSIS	RUBUS ALLEGHENIENSIS
PASPALUM NOTATUM	PASPALUM NOTATUM
KNAUTIA ARVENSIS	KNAUTIA ARVENSIS
SILYBUM MARIANUM	SILYBUM MARIANUM
TRAMETES VERSICOLOR	TRAMETES VERSICOLOR
ALCEA ROSEA	ALCEA ROSEA
CECROPIA PELTATA	CECROPIA PELTATA
DIANTHUS CRENATUS	DIANTHUS CRENATUS
SAMBUCUS NIGRA	ELDERBERRY
GLYCINE MAX	GLYCINE MAX
HYDRASTIS CANADENSIS	HYDRASTIS CANADENSIS
MANDRAGORA OFFICINARUM	MANDRAGORA OFFICINARUM
CRATAEGUS GRACILIOR	CRATAEGUS GRACILIOR
CENTAURIUM PULCHELLUM	CENTAURIUM PULCHELLUM
ELEUTHEROCOCCUS SENTICOSUS	ELEUTHEROCOCCUS SENTICOSUS
TARAXACUM OFFICINALE	TARAXACUM OFFICINALE
RHYNCHOSTYLIS RETUSA	RHYNCHOSTYLIS RETUSA
MAERUA CRASSIFOLIA	MAERUA CRASSIFOLIA
STACHYS MEXICANA	STACHYS MEXICANA
ALECTRA SESSILIFLORA	ALECTRA SESSILIFLORA
CLARKIA PURPUREA	CLARKIA PURPUREA
SALVIA OFFICINALIS	SALVIA OFFICINALIS
IPOMOEA DUMOSA	IPOMOEA DUMOSA
CLINACANTHUS NUTANS	CLINACANTHUS NUTANS
CORDIA DENTATA	CORDIA DENTATA
GLYCYRRHIZA URALENSIS	LICORICE
RHEUM PALMATUM	RHEUM PALMATUM
RUMEX CRISPUS	RUMEX CRISPUS
ACACIA SALIGNA	ACACIA SALIGNA
ALCHEMILLA XANTHOCHLORA	ALCHEMILLA XANTHOCHLORA
RUBUS PARVIFOLIUS	RUBUS PARVIFOLIUS
GANODERMA LUCIDUM	GANODERMA LUCIDUM
HANDROANTHUS HEPTAPHYLLUS	HANDROANTHUS HEPTAPHYLLUS
HORNY GOAT WEED	EPIMEDIUM PUBESCENS
MATRICARIA CHAMOMILLA	MATRICARIA CHAMOMILLA
GLYCYRRHIZA GLABRA	GLYCYRRHIZA GLABRA
SMILAX GLAUCA	SMILAX GLAUCA
FRAXINUS QUADRANGULATA	FRAXINUS QUADRANGULATA
PLECTRANTHUS AMBOINICUS	COLEUS
ABIES ALBA	ABIES ALBA
JUNIPERUS VIRGINIANA	JUNIPERUS VIRGINIANA
TRIBULUS TERRESTRIS	TRIBULUS TERRESTRIS
ARTEMISIA ANNUA	ARTEMISIA ANNUA
ORIGANUM COMPACTUM	ORIGANUM COMPACTUM
TANACETUM VULGARE	TANACETUM VULGARE
HAMAMELIS VIRGINIANA	HAMAMELIS VIRGINIANA
ARUM ITALICUM	ARUM ITALICUM
EUCLEA RACEMOSA	EUCLEA RACEMOSA
ARCTOSTAPHYLOS NEVADENSIS	ARCTOSTAPHYLOS NEVADENSIS
CARTHAMUS LANATUS	CARTHAMUS LANATUS
LEVISTICUM OFFICINALE	LEVISTICUM OFFICINALE
ARCTIUM LAPPA	ARCTIUM LAPPA
POGOSTEMON CABLIN	POGOSTEMON CABLIN
COPTIS	COPTIS
CITRUS RETICULATA	CITRUS RETICULATA
AMPELOCISSUS LATIFOLIA	AMPELOCISSUS LATIFOLIA
SOLIDAGO ODORA	SOLIDAGO ODORA
CALLICARPA AMERICANA	CALLICARPA AMERICANA
CAULOPHYLLUM THALICTROIDES	CAULOPHYLLUM THALICTROIDES
PICEA MARIANA	PICEA MARIANA
LUPINUS PERENNIS	LUPINUS PERENNIS
ASARUM CANADENSE	ASARUM CANADENSE
ADIANTUM LATIFOLIUM	ADIANTUM LATIFOLIUM
WARBURGIA UGANDENSIS	WARBURGIA UGANDENSIS
LEPIDIUM MEYENII	LEPIDIUM MEYENII
MAGNOLIA GRANDIFLORA	MAGNOLIA GRANDIFLORA
SESELI LIBANOTIS	SESELI LIBANOTIS
PARONYCHIA ARGENTEA	PARONYCHIA ARGENTEA
PONTEDERIA CORDATA	PONTEDERIA CORDATA
CITRUS AURANTIUM	CITRUS AURANTIUM
SPERMACOCE VERTICILLATA	SPERMACOCE VERTICILLATA
SENNA ALEXANDRINA	SENNA
SALVIA SCLAREA	SALVIA SCLAREA
ALCEA SETOSA	ALCEA SETOSA
ANETHUM GRAVEOLENS	ANETHUM GRAVEOLENS
AESCULUS HIPPOCASTANUM	AESCULUS HIPPOCASTANUM
RICINUS COMMUNIS	RICINUS COMMUNIS
PELTANDRA VIRGINICA	PELTANDRA VIRGINICA
CARYA ALBA	CARYA ALBA
CASTILLEJA MINIATA	CASTILLEJA MINIATA
CORNUS FLORIDA	CORNUS FLORIDA
QUERCUS STELLATA	QUERCUS STELLATA
DIANTHUS CARTHUSIANORUM	DIANTHUS CARTHUSIANORUM
TEUCRIUM CRETICUM	TEUCRIUM CRETICUM
FRANGULA ALNUS	FRANGULA ALNUS
TILIA AMERICANA	TILIA AMERICANA
ERYTHRINA CRISTA-GALLI	ERYTHRINA CRISTA-GALLI
QUERCUS CHRYSOLEPIS	QUERCUS CHRYSOLEPIS
CROTON DRACONOIDES	CROTON DRACONOIDES
MERTESIA VIRGINICA	MERTESIA VIRGINICA
LILIUM CANDIDUM	LILIUM CANDIDUM
ARENARIA LANUGINOSA	ARENARIA LANUGINOSA
CIRSIUM ERIOPHORUM	CIRSIUM ERIOPHORUM
GARCINIA GERRARDII	GARCINIA GERRARDII
MEUM ATHAMANTICUM	MEUM ATHAMANTICUM
CALLUNA VULGARIS	CALLUNA VULGARIS
PINUS ECHINATA	PINUS ECHINATA
ACHILLEA NOBILIS	ACHILLEA NOBILIS
JACOBAEA MARITIMA	JACOBAEA MARITIMA
BAPTISIA ALBA	BAPTISIA ALBA
COMMELINA DIFFUSA	COMMELINA DIFFUSA
TODDALIA ASIATICA	TODDALIA ASIATICA
LUDWIGIA ERECTA	LUDWIGIA ERECTA
ACACIA DEALBATA	ACACIA DEALBATA
EUPHORBIA OFFICINARUM	EUPHORBIA OFFICINARUM
PTELEA TRIFOLIATA	PTELEA TRIFOLIATA
ACANTHUS MOLLIS	ACANTHUS MOLLIS
RUBUS RIGIDUS	RUBUS RIGIDUS
TOONA SINENSIS	TOONA SINENSIS
FERULA SINKIANGENSIS	FERULA SINKIANGENSIS
ARALIA RACEMOSA	ARALIA RACEMOSA
ORIGANUM SYRIACUM	ORIGANUM SYRIACUM
MELISSA OFFICINALIS	MELISSA OFFICINALIS
IPOMOEA WOLCOTTIANA	IPOMOEA WOLCOTTIANA
CNIDOSCOLUS URENS	CNIDOSCOLUS URENS
ERIGERON STRIGOSUS	ERIGERON STRIGOSUS
ALLIUM PORRUM	ALLIUM PORRUM
MIKANIA SCANDENS	MIKANIA SCANDENS
DELPHINIUM GRANDIFLORUM	DELPHINIUM GRANDIFLORUM
ORIGANUM ONITES	ORIGANUM ONITES
PRUNELLA VULGARIS	PRUNELLA VULGARIS
DAPHNE GNIDIUM	DAPHNE GNIDIUM
ACER RUBRUM	ACER RUBRUM
SABAL MINOR	SABAL MINOR
OPUNTIA HUMIFUSA	OPUNTIA HUMIFUSA
ZANTHOXYLUM OVALIFOLIUM	ZANTHOXYLUM OVALIFOLIUM
FUMARIA OFFICINALIS	FUMARIA OFFICINALIS
BRASSICA JUNCEA	BRASSICA JUNCEA
AMOMUM AROMATICUM	AMOMUM AROMATICUM
OXYRIA DIGYNA	OXYRIA DIGYNA
LONICERA HYPOGLAUCA	LONICERA HYPOGLAUCA
ALOYSIA TRIPHYLLA	ALOYSIA TRIPHYLLA
PINUS SYLVESTRIS	PINUS SYLVESTRIS
CYMBOPOGON SCHOENANTHUS	CYMBOPOGON SCHOENANTHUS
SAMBUCUS CANADENSIS	SAMBUCUS CANADENSIS
EUTERPE OLERACEA	EUTERPE OLERACEA
RUBUS URSINUS	RUBUS URSINUS
COLEUS	PLECTRANTHUS AMBOINICUS
GUGGUL	COMMIPHORA MUKUL
CAPSELLA BURSA-PASTORIS	CAPSELLA BURSA-PASTORIS
XANTHIUM STRUMARIUM	XANTHIUM STRUMARIUM
LUDWIGIA PEPLOIDES	LUDWIGIA PEPLOIDES
JUNCUS TORREYI	JUNCUS TORREYI
SCHIZACHYRIUM SCOPARIUM	SCHIZACHYRIUM SCOPARIUM
THAPSIA GARGANICA	THAPSIA GARGANICA
GREWIA VILLOSA	GREWIA VILLOSA
CAMPSIS RADICANS	CAMPSIS RADICANS
GLYCYRRHIZA URALENSIS	GLYCYRRHIZA URALENSIS
PINUS PALUSTRIS	PINUS PALUSTRIS
RHEUM AUSTRALE	RHEUM AUSTRALE
VICIA FABA	VICIA FABA
LIMONIUM NARBONENSE	LIMONIUM NARBONENSE
EICHHORNIA CRASSIPES	EICHHORNIA CRASSIPES
MONESES UNIFLORA	MONESES UNIFLORA
LEPIDIUM DRABA	LEPIDIUM DRABA
PEUMUS BOLDUS	PEUMUS BOLDUS
MENTHA SPICATA	MENTHA SPICATA
VITIS VINIFERA	VITIS VINIFERA
GALEGA OFFICINALIS	GALEGA OFFICINALIS
LONICERA JAPONICA	LONICERA JAPONICA
GALIUM APARINE	GALIUM APARINE
VACCINIUM MYRSINITES	VACCINIUM MYRSINITES
AFRAMOMUM MELEGUETA	AFRAMOMUM MELEGUETA
PLANTAGO MAJOR	PLANTAGO MAJOR
TURNERA DIFFUSA	TURNERA DIFFUSA
NEPETA HINDOSTANA	NEPETA HINDOSTANA
PLANTAGO ARISTATA	PLANTAGO ARISTATA
SAMBUCUS EBULUS	SAMBUCUS EBULUS
SPHYRNA LEWINI	SPHYRNA LEWINI
ASCLEPIAS PERENNIS	ASCLEPIAS PERENNIS
PLECTRANTHUS ESCULENTUS	PLECTRANTHUS ESCULENTUS
BALLOTA NIGRA	BALLOTA NIGRA
CYCLAMEN HEDERIFOLIUM	CYCLAMEN HEDERIFOLIUM
SALVIA ROSMARINUS	SALVIA ROSMARINUS
CODONOPSIS PILOSULA	CODONOPSIS PILOSULA
GALIUM VERUM	GALIUM VERUM
Brassica Brassica oleracea	Brassica Brassica oleracea
DIOSCOREA VILLOSA	DIOSCOREA VILLOSA
HYDRASTIS CANADENSIS	GOLDENSEAL
PYROSTEGIA VENUSTA	PYROSTEGIA VENUSTA
PIPER NIGRUM	BLACK PEPPER
EQUISETUM HYEMALE	EQUISETUM HYEMALE
CORNUS OFFICINALIS	CORNUS OFFICINALIS
BOLETUS EDULIS	BOLETUS EDULIS
SYMPHYTUM OFFICINALE	SYMPHYTUM OFFICINALE
DIPSACUS FULLONUM	DIPSACUS FULLONUM
PALISOTA HIRSUTA	PALISOTA HIRSUTA
RUBUS CUNEIFOLIUS	RUBUS CUNEIFOLIUS
PLATANTHERA PSYCODES	PLATANTHERA PSYCODES
BAUHINIA DIVARICATA	BAUHINIA DIVARICATA
ERYTHRINA HERBACEA	ERYTHRINA HERBACEA
ASTRAGALUS MONSPESSULANUS	ASTRAGALUS MONSPESSULANUS
LYCOPUS AMERICANUS	LYCOPUS AMERICANUS
QUERCUS GAMBELII	QUERCUS GAMBELII
CERATONIA SILIQUA	CERATONIA SILIQUA
HELICHRYSUM ARENARIUM	HELICHRYSUM ARENARIUM
HYPERICUM PERFORATUM	HYPERICUM PERFORATUM
SESAMUM RADIATUM	SESAMUM RADIATUM
TYPHA DOMINGENSIS	TYPHA DOMINGENSIS
ZALUZIANSKYA CAPENSIS	ZALUZIANSKYA CAPENSIS
KALANCHOE CRENATA	KALANCHOE CRENATA
ARTOCARPUS ALTILIS	ARTOCARPUS ALTILIS
SCUTELLARIA LATERIFLORA	SCUTELLARIA LATERIFLORA
AGATHOSMA BETULINA	AGATHOSMA BETULINA
GARDENIA THUNBERGIA	GARDENIA THUNBERGIA
ASCLEPIAS INCARNATA	ASCLEPIAS INCARNATA
JUGLANS REGIA	JUGLANS REGIA
CRITHMUM MARITIMUM	CRITHMUM MARITIMUM
ARTEMISIA ARBORESCENS	ARTEMISIA ARBORESCENS
DAPHNE OLEOIDES	DAPHNE OLEOIDES
COLEUS	COLEUS
ECHINACEA ANGUSTIFOLIA	ECHINACEA ANGUSTIFOLIA
MOMORDICA COCHINCHINENSIS	MOMORDICA COCHINCHINENSIS
MITRACARPUS HIRTUS	MITRACARPUS HIRTUS
COLLOMIA LINEARIS	COLLOMIA LINEARIS
GALIUM TRIFLORUM	GALIUM TRIFLORUM
LESSERTIA TOMENTOSA	LESSERTIA TOMENTOSA
VACCINIUM ANGUSTIFOLIUM	VACCINIUM ANGUSTIFOLIUM
ALBIZIA CORIARIA	ALBIZIA CORIARIA
CITRULLUS LANATUS	CITRULLUS LANATUS
FRAXINUS ANGUSTIFOLIA	FRAXINUS ANGUSTIFOLIA
COMMELINA BENGHALENSIS	COMMELINA BENGHALENSIS
TEUCRIUM CHAMAEDRYS	TEUCRIUM CHAMAEDRYS
BRASSICA NIGRA	BRASSICA NIGRA
ORBEXILUM PEDUNCULATUM	ORBEXILUM PEDUNCULATUM
PILOBLEPHIS RIGIDA	PILOBLEPHIS RIGIDA
TOONA SINENSIS	CORDYCEPS
CERCIS CANADENSIS	CERCIS CANADENSIS
ARISTOTELIA CHILENSIS	ARISTOTELIA CHILENSIS
SALVIA MACROSIPHON	SALVIA MACROSIPHON
WISTERIA SINENSIS	WISTERIA SINENSIS
ERIGERON FLORIBUNDUS	ERIGERON FLORIBUNDUS
FERULA COMMUNIS	FERULA COMMUNIS
HYPERICUM HYPERICOIDES	HYPERICUM HYPERICOIDES
CERINTHE MAJOR	CERINTHE MAJOR
TYPHA LATIFOLIA	TYPHA LATIFOLIA
CRATAEGUS LAEVIGATA	CRATAEGUS LAEVIGATA
MAESA LANCEOLATA	MAESA LANCEOLATA
ARUNDO DONAX	ARUNDO DONAX
ENTEROLOBIUM CYCLOCARPUM	ENTEROLOBIUM CYCLOCARPUM
GINKGO BILOBA	GINKGO BILOBA
CLINOPODIUM BOLIVIANUM	CLINOPODIUM BOLIVIANUM
MIRABILIS JALAPA	MIRABILIS JALAPA
THELYPTERIS KUNTHII	THELYPTERIS KUNTHII
BIDENS PILOSA	BIDENS PILOSA
HARPAGOPHYTUM PROCUMBENS	HARPAGOPHYTUM PROCUMBENS
RUBUS FLAGELLARIS	RUBUS FLAGELLARIS
CROSSOPTERYX FEBRIFUGA	CROSSOPTERYX FEBRIFUGA
GARCINIA	GARCINIA
KADSURA JAPONICA	KADSURA JAPONICA
STADMANIA OPPOSITIFOLIA	STADMANIA OPPOSITIFOLIA
SESBANIA SESBAN	SESBANIA SESBAN
FOENICULUM VULGARE	FOENICULUM VULGARE
PARIETARIA JUDAICA	PARIETARIA JUDAICA
ATRACTYLODES MACROCEPHALA	ATRACTYLODES MACROCEPHALA
PISTACIA LENTISCUS	PISTACIA LENTISCUS
STACHYS BULLATA	STACHYS BULLATA
ASPARAGUS SETACEUS	ASPARAGUS SETACEUS
ELDERBERRY	SAMBUCUS NIGRA
GENTIANA PNEUMONANTHE	GENTIANA PNEUMONANTHE
RUSCUS ACULEATUS	RUSCUS ACULEATUS
MACLURA TINCTORIA	MACLURA TINCTORIA
HALOXYLON AMMODENDRON	HALOXYLON AMMODENDRON
DIOSPYROS VIRGINIANA	DIOSPYROS VIRGINIANA
PANAX GINSENG	PANAX GINSENG
CORYLUS AMERICANA	CORYLUS AMERICANA
ASPARAGUS RACEMOSUS	ASPARAGUS RACEMOSUS
ESCHSCHOLZIA CALIFORNICA	ESCHSCHOLZIA CALIFORNICA
CISTUS CRETICUS	CISTUS CRETICUS
VACCINIUM PALLIDUM	VACCINIUM PALLIDUM
PAULLINIA CUPANA	PAULLINIA CUPANA
VINCA MAJOR	VINCA MAJOR
CHELIDONIUM MAJUS	CHELIDONIUM MAJUS
PINUS NIGRA	PINUS NIGRA
ACORUS CALAMUS	ACORUS CALAMUS
GOLDENSEAL	GOLDENSEAL
NASTURTIUM OFFICINALE	NASTURTIUM OFFICINALE
GRINDELIA CILIATA	GRINDELIA CILIATA
VERONICA CHAMAEDRYS	VERONICA CHAMAEDRYS
GALIUM UNIFLORUM	GALIUM UNIFLORUM
DAUCUS CAROTA	DAUCUS CAROTA
COMMIPHORA MUKUL	COMMIPHORA MUKUL
CHRYSOPSIS MARIANA	CHRYSOPSIS MARIANA
PSEUDOGNAPHALIUM VISCOSUM	PSEUDOGNAPHALIUM VISCOSUM
CLINOPODIUM POLYCEPHALUM	CLINOPODIUM POLYCEPHALUM
SENNA OCCIDENTALIS	SENNA OCCIDENTALIS
QUASSIA AMARA	QUASSIA AMARA
AMARANTHUS SPINOSUS	AMARANTHUS SPINOSUS
ZIZANIA AQUATICA	ZIZANIA AQUATICA
ARMILLARIA GALLICA	ARMILLARIA GALLICA
PERIPLOCA LAEVIGATA	PERIPLOCA LAEVIGATA
ALLIUM MACROSTEMON	ALLIUM MACROSTEMON
BARBERRY	BERBERIS ARISTATA
CASTANEA DENTATA	CASTANEA DENTATA
ACALYPHA FRUTICOSA	ACALYPHA FRUTICOSA
RUTA GRAVEOLENS	RUTA GRAVEOLENS
MELILOTUS ALBUS	MELILOTUS ALBUS
GERANIUM MACULATUM	GERANIUM MACULATUM
TORMINALIS GLABERRIMA	TORMINALIS GLABERRIMA
ANEMONE HEPATICA	ANEMONE HEPATICA
OPLOPANAX HORRIDUS	OPLOPANAX HORRIDUS
LONICERA PERICLYMENUM	LONICERA PERICLYMENUM
CRATAEGUS AZAROLUS	CRATAEGUS AZAROLUS
QUERCUS ILEX	QUERCUS ILEX
GLYCYRRHIZA INFLATA	LICORICE
FRANGULA CAROLINIANA	FRANGULA CAROLINIANA
EMILIA SONCHIFOLIA	EMILIA SONCHIFOLIA
ASTRAGALUS PROPINQUUS	ASTRAGALUS PROPINQUUS
TEUCRIUM BOTRYS	TEUCRIUM BOTRYS
PIPER NIGRUM	PIPER NIGRUM
HYPERICUM REVOLUTUM	HYPERICUM REVOLUTUM
STERCULIA URENS	STERCULIA URENS
PSEUDOTSUGA MENZIESII	PSEUDOTSUGA MENZIESII
BERBERIS VULGARIS	BERBERIS VULGARIS
STILLINGIA SYLVATICA	STILLINGIA SYLVATICA
SIDA SPINOSA	SIDA SPINOSA
NEUROLAENA LOBATA	NEUROLAENA LOBATA
PASSIFLORA EDULIS	PASSIFLORA EDULIS
DIPLOTAXIS TENUIFOLIA	DIPLOTAXIS TENUIFOLIA
PINUS MUGO	PINUS MUGO
SOLIDAGO CANADENSIS	SOLIDAGO CANADENSIS
ERYTHRINA ABYSSINICA	ERYTHRINA ABYSSINICA
CENTAURIUM ERYTHRAEA	CENTAURIUM ERYTHRAEA
ARISTOLOCHIA FIMBRIATA	ARISTOLOCHIA FIMBRIATA
NEPETA TENUIFOLIA	NEPETA TENUIFOLIA
HYPERICUM PUNCTATUM	HYPERICUM PUNCTATUM
ARISTOLOCHIA RUGOSA	ARISTOLOCHIA RUGOSA
THUJA PLICATA	THUJA PLICATA
NYMPHAEA ODORATA	NYMPHAEA ODORATA
TRIGONELLA CORNICULATA	TRIGONELLA CORNICULATA
SMILAX ROTUNDIFOLIA	SMILAX ROTUNDIFOLIA
CASTANEA SATIVA	CASTANEA SATIVA
ERIOGONUM ALATUM	ERIOGONUM ALATUM
NEPHROLEPIS CORDIFOLIA	NEPHROLEPIS CORDIFOLIA
RUDBECKIA HIRTA	RUDBECKIA HIRTA
FOMITOPSIS PINICOLA	FOMITOPSIS PINICOLA
MAGNOLIA VIRGINIANA	MAGNOLIA VIRGINIANA
MARRUBIUM VULGARE	MARRUBIUM VULGARE
HORSETAIL	EQUISETUM HYEMALE
FICUS SAUSSUREANA	FICUS SAUSSUREANA
UNCARIA TOMENTOSA	UNCARIA TOMENTOSA
CLADIUM MARISCUS	CLADIUM MARISCUS
VITIS ROTUNDIFOLIA	VITIS ROTUNDIFOLIA
ERODIUM MALACOIDES	ERODIUM MALACOIDES
ERIODICTYON CALIFORNICUM	ERIODICTYON CALIFORNICUM
ANGELICA SINENSIS	ANGELICA SINENSIS
CARYA ILLINOINENSIS	CARYA ILLINOINENSIS
VITIS AESTIVALIS	VITIS AESTIVALIS
AGRIMONIA EUPATORIA	AGRIMONIA EUPATORIA
PETROSELINUM CRISPUM	PETROSELINUM CRISPUM
ARECA CATECHU	ARECA CATECHU
MENTHA PULEGIUM	MENTHA PULEGIUM
PRUNUS SEROTINA	PRUNUS SEROTINA
CICHORIUM INTYBUS	CICHORIUM INTYBUS
TABERNAEMONTANA AURANTIACA	TABERNAEMONTANA AURANTIACA
SALVIA MICROPHYLLA	SALVIA MICROPHYLLA
DICHORISANDRA HEXANDRA	DICHORISANDRA HEXANDRA
ALLIUM CEPA	ALLIUM CEPA
ANDROPOGON VIRGINICUS	ANDROPOGON VIRGINICUS
AMBROSIA ARTEMISIIFOLIA	AMBROSIA ARTEMISIIFOLIA
SCHISANDRA CHINENSIS	SCHISANDRA CHINENSIS
CANTINOA AMERICANA	CANTINOA AMERICANA
GENTIANA OLIVIERI	GENTIANA OLIVIERI
CHIONANTHUS VIRGINICUS	CHIONANTHUS VIRGINICUS
GOLDENSEAL	HYDRASTIS CANADENSIS
CUMINUM CYMINUM	CUMINUM CYMINUM
MEDICAGO POLYMORPHA	MEDICAGO POLYMORPHA
STACHYS TENUIFOLIA	STACHYS TENUIFOLIA
EUPATORIUM LINDLEYANUM	EUPATORIUM LINDLEYANUM
GYMNEMA SYLVESTRE	GYMNEMA SYLVESTRE
MAGNOLIA TRIPETALA	MAGNOLIA TRIPETALA
NIPHIDIUM CRASSIFOLIUM	NIPHIDIUM CRASSIFOLIUM
SALIX TRIANDRA	SALIX TRIANDRA
LECHEA MINOR	LECHEA MINOR
BLUMEA LACERA	BLUMEA LACERA
RHEXIA VIRGINICA	RHEXIA VIRGINICA
SPHAGNUM SQUARROSUM	SPHAGNUM SQUARROSUM
PYRUS NIVALIS	PYRUS NIVALIS
RAPHANUS RAPHANISTRUM	RAPHANUS RAPHANISTRUM
PERSICARIA MACULOSA	PERSICARIA MACULOSA
PRUNUS ARMENIACA	PRUNUS ARMENIACA
AMOMUM ACULEATUM	AMOMUM ACULEATUM
THYMUS PRAECOX	THYMUS PRAECOX
PLECTRANTHUS AMBOINICUS	PLECTRANTHUS AMBOINICUS
EPIMEDIUM PUBESCENS	HORNY GOAT WEED
CORYLUS AVELLANA	CORYLUS AVELLANA
SOLANUM CAROLINENSE	SOLANUM CAROLINENSE
ERIOBOTRYA JAPONICA	ERIOBOTRYA JAPONICA
ZANTHOXYLUM SIMULANS	ZANTHOXYLUM SIMULANS
ELYMUS REPENS	ELYMUS REPENS
SALIX LUCIDA	SALIX LUCIDA
GLYCYRRHIZA INFLATA	GLYCYRRHIZA INFLATA
ENDOTROPIS ALNIFOLIA	ENDOTROPIS ALNIFOLIA
LICORICE	LICORICE
BIDENS BIPINNATA	BIDENS BIPINNATA
ACHILLEA AGERATUM	ACHILLEA AGERATUM
KHAYA ANTHOTHECA	KHAYA ANTHOTHECA
SENNA ALEXANDRINA	SENNA ALEXANDRINA
EUPATORIUM JAPONICUM	EUPATORIUM JAPONICUM
PISTIA STRATIOTES	PISTIA STRATIOTES
RUBUS TRIVIALIS	RUBUS TRIVIALIS
PERSICARIA HYDROPIPEROIDES	PERSICARIA HYDROPIPEROIDES
AMANITA RUBESCENS	AMANITA RUBESCENS
BIXA ORELLANA	BIXA ORELLANA
ARTEMISIA ABSINTHIUM	ARTEMISIA ABSINTHIUM
APIUM GRAVEOLENS	APIUM GRAVEOLENS
SOLANUM NIGRUM	SOLANUM NIGRUM
DRIMA MARITIMA	DRIMA MARITIMA
COPTIS CHINENSIS	COPTIS CHINENSIS
JUNIPERUS COMMUNIS	JUNIPERUS COMMUNIS
POLIOMINTHA INCANA	POLIOMINTHA INCANA
CRATAEGUS MONOGYNA	CRATAEGUS MONOGYNA
LINARIA VULGARIS	LINARIA VULGARIS
CASTANEA MOLLISSIMA	CASTANEA MOLLISSIMA
PLATANUS OCCIDENTALIS	PLATANUS OCCIDENTALIS
SOLANUM LINNAEANUM	SOLANUM LINNAEANUM
HORNY GOAT WEED	HORNY GOAT WEED
