"pt"	"lb"	"mappings"
Aloe vera	Aloe vera	Aloe | Aloe vera | Barbados aloe | Curaçao aloe | True aloe | West Indian aloe
Americanbugleweed	Lycopus americanus	Americanbugleweed | Lycopus americanus
Americanchestnut	Castanea dentata	Americanchestnut | Castanea dentata
Americanpersimmon	Diospyros virginiana	Americanpersimmon | Diospyros virginiana
American spikenard	Aralia racemosa	American spikenard | Aralia racemosa
AmericanSycamore	Platanus occidentalis	AmericanSycamore | Platanus occidentalis
Apple cider vinegar	Malus domestica	Apple cider vinegar | Malus domestica | Malus pumila
Apple cider vinegar	Malus pumila	Apple cider vinegar | Malus domestica | Malus pumila
Ashwaganda	Withania somnifera	Asgandh | Ashwaganda | Ashwagandha | Asvagandha | Indian ginseng | Winter-cherry | Withania somnifera
Barley grass	Hordeum vulgare	Barley grass | Da mai | Hordeum vulgare
Bataviacinnamon	Cinnamomum burmanni	Bataviacinnamon | Cinnamomum burmanni
Bear's breeches	Acanthus mollis	Acanthus mollis | Bear's breeches
Beet root	Beta vulgaris	Beet | Beet root | Beta vulgaris | Field beet | Fodder beet | Foliage beet | Garden beet | Mangel | Mangel-wurzel | Mangold | Red beet | Sicilian broad-rib beet | Spinach beet | Spinach chard | Sugar beet | Swiss chard | Tian cai | Yellow beet
Berberislycium	Berberis lycium	Berberis lycium | Berberislycium
Bing lang	Areca catechu	Areca catechu | Areca palm | Bing lang
Black cherry	Prunus serotina	Black cherry | Prunus serotina | Rum cherry | Wild cherry
Black cohosh	Actaea racemosa	Actaea racemosa | Black bugbane | Black cohosh | Black snakeroot
Black cumin	Nigella sativa	Black cumin | Nigella sativa
Blackwalnut	Juglans nigra	Blackwalnut | Juglans nigra
Bluejackoak	Quercus incana	Bluejackoak | Quercus incana
Boldu	Peumus boldus	Boldo | Boldo tree | Boldu | Peumus boldus
Boswellia	Boswellia serrata	Boswellia | Boswellia serrata
Boysenberry	Rubus ursinus	Boysenberry | Rubus ursinus
Breadfruit	Artocarpus altilis	Artocarpus altilis | Breadfruit
Butcher's-broom	Ruscus aculeatus	Box-holly | Butcher's-broom | Ruscus aculeatus
Cabbage palm	Euterpe oleracea	Acai | Açai | Assai palm | Cabbage palm | Euterpe oleracea
California-poppy	Eschscholzia californica	California-poppy | Eschscholzia californica
CanadianGoldenrod	Solidago canadensis	CanadianGoldenrod | Solidago canadensis
Canadian horseweed	Conyza canadensis	Butterweed | Canadian horseweed | Conyza canadensis
Caperbush	Capparis spinosa	Caper | Caperbush | Capparis spinosa
Carilla gourd	Momordica charantia	Balsam-apple | Balsam-pear | Bitter-cucumber | Bitter gourd | Bitter melon | Carilla gourd | Momordica charantia
Carrot	Daucus carota	Carrot | Daucus carota
Cat's-claw	Uncaria tomentosa	Cat's-claw | Uncaria tomentosa
Celery	Apium graveolens	Apium graveolens | Celery
Chaga	Inonotus obliquus	Chaga | Inonotus obliquus
Chamomile	Matricaria chamomilla	Blue chamomile | Chamomile | Common chamomile | German chamomile | Hungarian chamomile | Matricaria | Matricaria chamomilla | Scented chamomile | Scented mayweed | Sweet false chamomile | True chamomile | Wild chamomile
Chlorella	Chlorella vulgaris	Chlorella | Chlorella vulgaris
Cinnamon	Cinnamomum cassia	Cassia | Cassia cinnamon | Ceylon cinnamon | Chinese cinnamon | Chinese cinnamon tree | Cinnamomum cassia | Cinnamomum verum | Cinnamon | Rou gui | True cinnamon | Tvak
Cinnamon	Cinnamomum verum	Cassia | Cassia cinnamon | Ceylon cinnamon | Chinese cinnamon | Chinese cinnamon tree | Cinnamomum cassia | Cinnamomum verum | Cinnamon | Rou gui | True cinnamon | Tvak
Clary sage	Salvia sclarea	Clary | Clary sage | Salvia sclarea
Cordyceps	Ophiocordyceps sinensis	Cordyceps | Ophiocordyceps sinensis
Cordycepsmilitaris	Cordyceps militaris	Cordyceps militaris | Cordycepsmilitaris
Couchgrass	Elymus repens	Couchgrass | Elymus repens
Cranberry	Vaccinium macrocarpon	Cranberry | Vaccinium macrocarpon
Cumin	Cuminum cyminum	Cumin | Cuminum cyminum
Da hua long ya cao	Agrimonia eupatoria	Agrimonia eupatoria | Agrimony | Da hua long ya cao
Damiana	Turnera diffusa	Damiana | Turnera diffusa
Dang shen	Codonopsis pilosula	Bellflower | Codonopsis pilosula | Dang shen
Devil's-club	Oplopanax horridus	Devil's-club | Oplopanax horridus
Dog rose	Rosa canina	Common briar | Dogbrier | Dog rose | Rosa canina
Douglas-fir	Pseudotsuga menziesii	Douglas-fir | Pseudotsuga menziesii
Echinacea	Echinacea angustifolia	Black sampson | Black-sampson echinacea | Eastern purple-coneflower | Echinacea | Echinacea angustifolia | Echinacea purpurea | Kansas snakeroot | Narrow-leaf coneflower | Narrow-leaf echinacea | Narrow-leaf purple-coneflower | Purple-coneflower
Echinacea	Echinacea purpurea	Black sampson | Black-sampson echinacea | Eastern purple-coneflower | Echinacea | Echinacea angustifolia | Echinacea purpurea | Kansas snakeroot | Narrow-leaf coneflower | Narrow-leaf echinacea | Narrow-leaf purple-coneflower | Purple-coneflower
Endrino	Prunus spinosa	Blackthorn | Endrino | Prunus spinosa
Europeanfieldelm	Ulmus minor	Europeanfieldelm | Ulmus minor
Evening primrose oil	Oenothera biennis	Evening primrose oil | Oenothera biennis
Falsa acacia	Robinia pseudoacacia	Black locust | Falsa acacia | Robinia pseudoacacia
Favabean	Vicia faba	Favabean | Vicia faba
Fennel	Foeniculum vulgare	Fennel | Fenouil | Foeniculum vulgare
Fenugreek	Trigonella foenum	Common fenugreek | Fenugreek | Greek-clover | Greek hay | Hu lu ba | Trigonella foenum
Ferulaelaeochytris	Ferula elaeochytris	Ferula elaeochytris | Ferulaelaeochytris
Feverfew	Tanacetum parthenium	Feverfew | Tanacetum parthenium
Field balm	Nepeta cataria	Catmint | Catnep | Catnip | Catswort | Field balm | Nepeta cataria
Flax seed	Linum usitatissimum	Flax | Flax seed | Flaxseed | Linseed | Linum usitatissimum
Fomesfomentarius	Fomes fomentarius	Fomes fomentarius | Fomesfomentarius
Fragrant everlasting	Pseudognaphalium obtusifolium	Blunt-leaved everlasting | Fragrant everlasting | Pseudognaphalium obtusifolium
Fragrant goldenrod	Solidago odora	Anise-scent goldenrod | Fragrant goldenrod | Solidago odora
Fringedrue	Ruta chalepensis	Fringedrue | Ruta chalepensis
Garden rock	Eruca vesicaria	Arugula | Eruca vesicaria | Garden rock
Garlic	Allium sativum	Allium sativum | Garlic
Ginger	Zingiber officinale	Ginger | Jiang | Zingiber officinale
Ginkgo	Ginkgo biloba	Baiguo | Ginkgo | Ginkgo biloba | Icho | Maidenhair-tree
Glossy buckthorn	Frangula alnus	Alder buckthorn | Frangula | Frangula alnus | Glossy buckthorn
Goat's-rue	Galega officinalis	French lilac | Galega | Galega officinalis | Goat's-rue
Goji berry	Lycium barbarum	Barbary matrimony-vine | Barbary wolfberry | Chinese wolfberry | Goji berry | Lycium barbarum | Matrimony-vine | Ning xia gou qi
Goose-grass	Galium aparine	Catchweed bedstraw | Cleavers | Galium aparine | Goose-grass
Grapefruit	Citrus paradisi	Citrus paradisi | Grapefruit
Grapevine	Vitis vinifera	Common grapevine | European grape | Grape | Grapevine | Vitis vinifera
Green tea	Camellia sinensis	Black tea | Camellia sinensis | Green tea | Oolong tea | Tea | White Tea
Guarana	Paullinia cupana	Guarana | Paullinia cupana
Guelder rose	Viburnum opulus	Crampbark | Guelder rose | Viburnum opulus
Guinea-pepper	Aframomum melegueta	Aframomum melegueta | Guinea-pepper
Hairyrockrose	Cistus creticus	Cistus creticus | Hairyrockrose
Hare's-ear	Bupleurum chinense	Bei chai hu | Bupleurum | Bupleurum chinense | Chai hu | Chinese thoroughwax | Hare's-ear
Hazelnut tree	Corylus avellana	Cobnut | Corylus avellana | European filbert | European hazel | Giant filbert | Hazel | Hazelnut tree
Hedgemustard	Sisymbrium officinale	Hedgemustard | Sisymbrium officinale
Hemp extract	Cannabis sativa	Cannabis sativa | Cannibidiol | Da ma | Hemp | Hemp extract | Marijuana
He shou wu	Reynoutria multiflora	Fleeceflower | Fo-ti | He shou wu | Reynoutria multiflora
Horehound	Marrubium vulgare	Horehound | Marrubium vulgare | White horehound
Horse-chestnut	Aesculus hippocastanum	Aesculus hippocastanum | Common horse chestnut | Horse-chestnut
Huang lian	Coptis chinensis	Chinese goldthread | Coptis chinensis | Golden thread | Huang lian | Huanglian
Hyssop	Hyssopus officinalis	Hyssop | Hyssopus officinalis
Indian bdellium-tree	Commiphora mukul	Commiphora mukul | Guggul | Gugul | Indian bdellium-tree
Ivy leaf	Hedera helix	Engelse hedera | English ivy | Hedera helix | Ivy leaf
Jackass bitters	Neurolaena lobata	Gavilana | Jackass bitters | Neurolaena lobata
Japanese aralia	Aralia spinosa	Aralia spinosa | Cong mu | Japanese angelica-tree | Japanese aralia
Juniper	Juniperus communis	Common juniper | Juniper | Juniperus communis
Karcura	Curcuma zedoaria	Curcuma zedoaria | Karcura
Kava	Piper methysticum	Kava | Kava-kava | Kava pepper | Kawa pepper | Piper methysticum | Yanggona
Kiratatikta	Swertia chirata	Chirata | Chiretta | Kiratatikta | Swertia chirata
Kola	Cola nitida	Bitter cola | Cola nitida | Gbanja kola | Kola
Kratom	Mitragyna speciosa	Kratom | Kratum | Mitragyna speciosa
Kuandonghua	Tussilago farfara	Coltsfoot | Common coltsfoot | Kuan dong | Kuandonghua | Tussilago farfara
Kuso-no-ki	Cinnamomum camphora	Camphor | Camphor laurel | Camphor tree | Camphortree | Cinnamomum camphora | Japanese camphor | Kuso-no-ki
Lady's-mantle	Alchemilla xanthochlora	Alchemilla xanthochlora | Lady's-mantle
Lentiscus	Pistacia lentiscus	Chios mastictree | Lentiscus | Pistacia lentiscus
Lesser galangal	Alpinia officinarum	Alpinia officinarum | Chinese-ginger | Lesser galanga | Lesser galangal
Licorice	Glycyrrhiza uralensis	Chinese licorice | Gan cao | Glycyrrhiza uralensis | Licorice
Lion's-tooth	Taraxacum officinale	Common dandelion | Dandelion | Lion's-tooth | Taraxacum officinale
Liquorice	Glycyrrhiza glabra	Glycyrrhiza glabra | Guang guo gan cao | Licorice | Liquorice
Lovage	Levisticum officinale	Levisticum officinale | Lovage
Lungmoss	Lobaria pulmonaria	Lobaria pulmonaria | Lung lichen | Lungmoss
Maca	Lepidium meyenii	Lepidium meyenii | Maca | Peruvian-ginseng
Magnolia-bark	Magnolia officinalis	Hou po | Magnolia-bark | Magnolia officinalis
Maidenhair fern	Adiantum capillus	Adiantum capillus | Common maidenhair | Maidenhair fern
Malabartamarind	Garcinia gummi	Garcinia gummi | Malabartamarind
Maocangzhu	Atractylodes lancea	Atractylodes lancea | Maocangzhu
Maqui	Aristotelia chilensis	Aristotelia chilensis | Maqui
Marrubium Nigrum	Ballota nigra	Ballota | Ballota nigra | Black hempnettle | Black horehound | Black Stinking Horehound | Marrubium Nigrum
Meadow sage	Salvia pratensis	Meadow clary | Meadow sage | Salvia pratensis
Mediterraneantapeweed	Posidonia oceanica	Mediterraneantapeweed | Posidonia oceanica
Melissa	Melissa officinalis	Balm | Bee balm | Lemon balm | Melissa | Melissa officinalis
Milk thistle	Silybum marianum	Blessed milk thistle | Gundagai thistle | Holy thistle | Lady's thistle | Mary's thistle | Mary thistle | Milk thistle | Silybum marianum | St. Mary's thistle | Variegated thistle
Miracle-fruit	Gymnema sylvestre	Gymnema | Gymnema sylvestre | Miracle-fruit
Moringa	Moringa oleifera	Ben-oil-tree | Benzolive-tree | Drumsticktree | Horseradish-tree | Malunggay | Moringa | Moringa oleifera | West Indian ben
Moroccanoregano	Origanum compactum	Moroccanoregano | Origanum compactum
Motherwort	Leonurus cardiaca	Common motherwort | Leonurus cardiaca | Motherwort
Mountain buchu	Agathosma betulina	Agathosma betulina | Buchu | Honey buchu | Mountain buchu
Muscadine grape	Vitis rotundifolia	Fox grape | Muscadine | Muscadine grape | Vitis rotundifolia
Mu zei	Equisetum hyemale	Common scouring-rush | Equisetum hyemale | Mu zei
Myrtle	Myrtus communis	Myrtle | Myrtus communis
Nimtree	Azadirachta indica	Azadirachta indica | Indian-lilac | Margosa | Neem | Nimtree
Niu bang zi	Arctium lappa	Arctium lappa | Burdock | Burr seed | Cocklebur | Edible burdock | Gobo | Goboshi | Great burdock | Great burdocks | Greater burdock | Hardock | Harebur | Lappa | Niu bang zi
Olive tree	Olea europaea	Olea europaea | Olive | Olive-leaf | Olive tree
One-style hawthorn	Crataegus monogyna	Crataegus monogyna | Hawthorn | Oneseed hawthorn | One-style hawthorn
Oregano	Origanum vulgare	Common Oregano | Oregano | Origanum vulgare
Oregon-grape	Berberis aquifolium	Berberis aquifolium | Blue barberry | Holly barberry | Holly mahonia | Mahonia | Mountain grape | Mountain-grape | Oregon grape | Oregon-grape
Oriental mustard	Brassica juncea	Brassica juncea | Indian mustard | Oriental mustard
Panax ginseng	Panax ginseng	Asian ginseng | Chinese ginseng | Hong shen | Korean ginseng | Korean red ginseng | Oriental ginseng | Panax ginseng | Red ginseng | Ren shen
Parsley	Petroselinum crispum	Parsley | Petroselinum crispum
Parsley- Chinese	Coriandrum sativum	Chinese parsley | Chinese-parsley | Cilantro | Coriander | Coriandrum sativum | Parsley- Chinese
Patchouly	Pogostemon cablin	Cablin patchouli | Guang huo xiang | Patchouli-plant | Patchouly | Pogostemon cablin
Pau d'Arco	Handroanthus heptaphyllus	Handroanthus heptaphyllus | Ipe roxo | Lapacho | Lapacho negro | Pau d'Arco
Pepperweed	Lepidium	Du xing cai | Lepidium | Pepperweed
Phyllanthusamarus	Phyllanthus amarus	Phyllanthus amarus | Phyllanthusamarus
Pi ba	Eriobotrya japonica	Bibasse | Eriobotrya japonica | Japanese-medlar | Loquat | Lukwart | Nispero | Pi ba
piprage	Berberis vulgaris	Berberis vulgaris | Common barberry | European barberry | Jaundice-berry | piprage
Piptoporusbetulinus	Piptoporus betulinus	Piptoporus betulinus | Piptoporusbetulinus
Pitch pine	Pinus palustris	Longleaf pine | Pinus palustris | Pitch pine
Plantain	Plantago major	Broadleaf plantain | Common plantain | Greater plantain | Plantago major | Plantain
Poison-ash	Chionanthus virginicus	Chionanthus virginicus | Fringetree | Old-man's-beard | Poison-ash
PoisonBerry	Solanum anguivi	PoisonBerry | Solanum anguivi
Prince's-pine	Chimaphila umbellata	Bitter wintergreen | Chimaphila umbellata | Ground ivy | Pipsissewa | Pipsissiwa | Prince's-pine
Purplegranadilla	Passiflora edulis	Passiflora edulis | Purplegranadilla
Qiang huo	Notopterygium incisum	Notopterygium | Notopterygium incisum | Qiang huo
Quassia wood	Quassia amara	Quassia | Quassia amara | Quassia wood
Radicchio	Cichorium intybus	Belgium endive | Chicory | Cichorium intybus | Radicchio
Red-berry juniper	Juniperus oxycedrus	Cade juniper | Juniperus oxycedrus | Prickly juniper | Red-berry juniper
Red yeast rice	Oryza sativa	Oryza sativa | Red yeast rice
Reishi	Ganoderma lucidum	Ganoderma | Ganoderma lucidum | Ling zhi | Reishi
Rendongteng	Lonicera japonica	Japanese honeysuckle | Jin yin hua | Lonicera japonica | Ren dong | Rendongteng
Rhodiola	Rhodiola rosea	Hong jing tian | King's-crown | Rhodiola | Rhodiola rosea | Roseroot
Rocou	Bixa orellana	Annatto | Arnatto | Bixa orellana | Lipsticktree | Rocou
Rooisede	Juniperus virginiana	Eastern red-cedar | Juniperus virginiana | Pencil-cedar | Potloodseder | Red-cedar | Red juniper | Rooisede
Rose laurel	Nerium oleander	Nerium oleander | Oleander | Rose laurel
Rosemary	Rosmarinus officinalis	Rosemary | Rosmarinus officinalis
Rotahorn	Acer rubrum	Acer rubrum | Red maple | Rotahorn
Rotten cheesefruit	Morinda citrifolia	Indian-mulberry | Morinda citrifolia | Noni | Rotten cheesefruit
Rue	Ruta graveolens	Rue | Ruta graveolens
Sage	Salvia officinalis	Common sage | Dalmatian sage | Garden sage | Sage | Salvia officinalis
Sargassumpallidum	Sargassum pallidum	Sargassum pallidum | Sargassumpallidum
Scots heather	Calluna vulgaris	Calluna vulgaris | Common heather | Heather | Ling | Red-heath | Scotch heather | Scots heather
Scots pine	Pinus nigra	Baltic redwood | Pinus nigra | Pinus sylvestris | Scotch pine | Scots pine
Scots pine	Pinus sylvestris	Baltic redwood | Pinus nigra | Pinus sylvestris | Scotch pine | Scots pine
Scrub-palmetto	Serenoa repens	Sabal | Saw palmetto | Saw-palmetto | Scrub-palmetto | Serenoa repens
Sea-fennel	Crithmum maritimum	Crithmum maritimum | Rock samphire | Sea-fennel
Seawrack	Fucus vesiculosus	Black tang | Bladder fucus | Fucus vesiculosus | Kelpware | Seawrack
Seed- rape	Brassica oleracea	Brassica oleracea | Colza | Rape | Rape seed | Seed- rape
Senna	Senna alexandrina	Senna | Senna alexandrina
Shallot	Allium cepa	Allium cepa | Onion | Shallot
Shan zhu yu	Cornus officinalis	Asiatic cornelian cherry | Asiatic dogwood | Cornus officinalis | Shan zhu yu
Shatavari	Asparagus racemosus	Asparagus racemosus | Shatamuli | Shatavari
Shepherd's-purse	Capsella bursa	Capsella bursa | Shepherd's-purse
Shi luo	Anethum graveolens	Anethum graveolens | Dill | Garden dill | Shi luo
Shinyblueberry	Vaccinium myrsinites	Shinyblueberry | Vaccinium myrsinites
Shirley poppy	Papaver rhoeas	Corn poppy | Field poppy | Flanders poppy | Papaver rhoeas | Shirley poppy
Shrub-trefoil	Ptelea trifoliata	Hoptree | Ptelea trifoliata | Shrub-trefoil
Siberian ginseng	Eleutherococcus senticosus	Ci wu jia | Eleuthero | Eleutherococcus senticosus | Siberian ginseng
Sicklepod senna	Senna obtusifolia	Java-bean | Senna obtusifolia | Sicklepod | Sicklepod senna
Siler	Saposhnikovia divaricata	Fang feng | Saposhnikovia divaricata | Siler
Silktree albizia	Albizia julibrissin	Albizia julibrissin | Happiness Tree | He huan | Mimosa | Silktree | Silktree albizia
Silver fir	Abies alba	Abies alba | European silver fir | Silver fir
Slippery elm	Ulmus rubra	Red elm | Slippery elm | Ulmus rubra
Slippery-root	Symphytum officinale	Boneset | Comfrey | Common comfrey | Consound | Healing-herb | Knitbone | Slippery-root | Symphytum officinale
Small centaury	Centaurium erythraea	Centaurium erythraea | Centaury | Common centaury | European centaury | Small centaury
Soapwort	Saponaria officinalis	Bouncing-bet | Saponaria officinalis | Soapwort
Soft rush	Juncus effusus	Common rush | Deng xin cao | Juncus effusus | Soft rush
Southern magnolia	Magnolia grandiflora	Bull bay | Laurier tulipier | Magnolia grandiflora | Southern magnolia
Sow thistle	Emilia sonchifolia	Cupid's shaving-brush | Emilia | Emilia sonchifolia | Sow thistle
Soybean	Glycine max	Black soya bean | Da dou | Glycine max | Soy | Soya | Soyabean | Soybean
Spanishmoss	Tillandsia usneoides	Spanishmoss | Tillandsia usneoides
Spanish-needles	Bidens pilosa	Bidens pilosa | Hairy beggar-ticks | Spanish-needles
Spearmint	Mentha spicata	Curled mint | Mentha spicata | Spearmint
Spiny Amaranth	Amaranthus spinosus	Amaranthus spinosus | Prickly Amaranth | Spiny Amaranth
Spreading pellitory	Parietaria judaica	Parietaria judaica | Pellitory-of-the-wall | Spreading pellitory
Spring restharrow	Ononis spinosa	Ononis | Ononis spinosa | Restharrow | Spiny restharrow | Spring restharrow
Squawmint Tickweed	Mentha pulegium	European pennyroyal | Lurk-in-the-Ditch | Mentha pulegium | Mosquito plant | Pennyroyal | Pudding Grass | Pulegium | Run-by-the-Ground | Squaw Balm | Squawmint Tickweed
Squawroot	Caulophyllum thalictroides	Blue cohosh | Caulophyllum | Caulophyllum thalictroides | Papooseroott | Squawroot
Squawvine	Mitchella repens	Mitchella repens | Partridge-berry | Squawvine
Stevia	Stevia rebaudiana	Stevia | Stevia rebaudiana
Stinging nettle	Urtica dioica	Common nettle | European nettle | Greater nettle | Nettle | Stinging nettle | Urtica dioica | Yi zhu qian ma
Stinkingweed	Senna occidentalis	Antbush | Coffee senna | Negro-coffee | Senna occidentalis | Stinkingweed
St. John's-bread	Ceratonia siliqua	Bread- St John's | Carob | Ceratonia | Ceratonia siliqua | Locust-bean | St John's bread | St. John's-bread
St. John's-wort	Hypericum perforatum	Hypericum | Hypericum perforatum | St. John's wort | St. John's-wort
Suan cheng	Citrus aurantium	Bitter orange | Citrus aurantium | Seville orange | Suan cheng
Sugarmaple	Acer floridanum	Acer floridanum | Sugarmaple
Swallowwort	Chelidonium majus	Celandine | Chelidonium majus | Great celandine | Greater celandine | Nipplewort | Swallowwort
Sweetbay	Magnolia virginiana	Magnolia virginiana | Sweetbay
Sweet chestnut	Castanea sativa	Castanea sativa | European chestnut | Sweet chestnut
Sweet Elder	Sambucus canadensis	American elder | Canadian elder | Sambucus canadensis | Sambucus nigra | Sweet Elder
Sweet Elder	Sambucus nigra	American elder | Canadian elder | Sambucus canadensis | Sambucus nigra | Sweet Elder
Sweet-gum	Liquidambar styraciflua	Alligatorwood | American-storax | Liquidambar styraciflua | Red-gum | Satin-walnut | Sweet-gum
Sweet joe-pye-weed	Eupatorium purpureum	Eupatorium purpureum | Gravelroot | Green-stem joe-pye-weed | Joe-pye | Joe-pye-weed | Marsh-milkweed | Queen-of-the-meadow | Sweet joe-pye-weed
Sweet marjoram	Origanum majorana	Marjoram | Origanum majorana | Sweet marjoram
Sweetroot	Acorus calamus	Acorus calamus | Calamus | Flagroot | Myrtle-flag | Sweet calamus | Sweet-flag | Sweetroot
Sweetwaterlily	Nymphaea odorata	Nymphaea odorata | Sweetwaterlily
Sweet wormwood	Artemisia annua	Artemisia annua | Huang hua hao | Sweet Annie | Sweet wormwood
Swiss mountain pine	Pinus mugo	Dwarf pine | Mountain pine | Mountain pine- Swiss | Mugo pine | Pine- pumilio | Pine- Swiss mountain | Pinus mugo | Pumilio pine | Scrub mountain pine | Swiss mountain pine
Syrian oregano	Origanum syriacum	Biblical hyssop | Lebanese oregano | Origanum syriacum | Syrian oregano
Szechwan chinaberry	Melia azedarach	Chinaberry | Lian | Melia azedarach | Persian lilac | Sichuan pagoda-tree | Szechwan chinaberry
Talewort	Borago officinalis	Beebread | Beeplant | Borage | Borago officinalis | Star-flower | Talewort
Tall mallow	Malva sylvestris	Blue mallow | Cheeses | Common mallow | High mallow | Malva sylvestris | Tall mallow
Tamarind	Tamarindus indica	Indian tamarind | Kilytree | Tamarin | Tamarind | Tamarindus indica
Tangerine	Citrus reticulata	Citrus reticulata | Ju | Mandarin orange | Tangerine
Tang-kuei	Angelica sinensis	Angelica sinensis | Chinese Angelica | Dang quai | Dang qui | Dong gui | Dong quai | Tang-kuei
Tanner's sumac	Rhus coriaria	Rhus coriaria | Sicilian sumac | Tanner's sumac
Tansy	Tanacetum vulgare	Golden-buttons | Tanacetum vulgare | Tansy
Tao	Prunus persica	Momo | Peach | Prunus persica | Tao
Tetterwort	Sanguinaria canadensis	Bloodroot | Bloodwort | Canadian bloodroot | Red puccoon | Redroot | Sanguinaria canadensis | Tetterwort
Thyme	Thymus vulgaris	Common thyme | Conehead thyme | English thyme | French thyme | Garden thyme | Thyme | Thymus vulgaris
Toothed medic	Medicago polymorpha	Bur medic | California bur-clover | Hairy medic | Medicago polymorpha | Toothed bur-clover | Toothed medic
Touch-me-not	Mimosa pudica	Han xiu cao | Mimosa pudica | Sensitive-plant | Touch-me-not
Tree-turmeric	Berberis aristata	Berberis aristata | Indian barberry | Tree-turmeric
Tribulus	Tribulus terrestris	Caltrop | Cat's-head | Common dubbletjie | Devil's-thorn | Devil's-weed | Goathead | Gokshura | Goksura | Ji li | Puncturevine | Puncturevine caltrop | Tribulus | Tribulus terrestris
Tulsi	Ocimum tenuiflorum	Holy basil | Ocimum tenuiflorum | Rama tulsi | Sacred basil | Tulsi
Turmeric	Curcuma longa	Common turmeric | Curcuma | Curcuma longa | Indian-saffron | Jianghuang | Turmeric | Yellow ginger
Tyfon	Brassica rapa	Brassica rapa | Rapini | Seven-top turnip | Turnip | Tyfon
Uva ursi	Arctostaphylos uva	Arctostaphylos uva | Bearberry | Kinnikinnick | Uva ursi
Valencia orange	Citrus sinensis	Blood orange | Citrus sinensis | Navel orange | Red orange | Sweet orange | Tian cheng | Valencia orange
Valerian	Valeriana officinalis	Common valerian | Garden-heliotrope | Garden valerian | Valerian | Valeriana officinalis
Velvet-dock	Inula helenium	Aaron's-rod | Common mullein | Elecampane | Flannelleaf | Flannelplant | Great mullein | Hag taper | Inula helenium | Mullein | Torches | Tu mu xiang | Velvet-dock | Verbascum thapsus
Velvet-dock	Verbascum thapsus	Aaron's-rod | Common mullein | Elecampane | Flannelleaf | Flannelplant | Great mullein | Hag taper | Inula helenium | Mullein | Torches | Tu mu xiang | Velvet-dock | Verbascum thapsus
Villous amomum	Amomum villosum	Amomum villosum | Sha ren | Sharen | Villous amomum
Virginian skullcap	Scutellaria lateriflora	Helmet flower | Hoodwort | Mad-dog scullcap | Quarter bonnet | Scullcap | Scutellaria lateriflora | Skullcap | Virginian skullcap
Virginia poke	Phytolacca americana	Chui xu shang lu | Phytolacca americana | Pigeonberry | Poke | Pokeberry | Pokeroot | Pokeweed | Virginia poke
Vitex	Vitex agnus	Chasteberry | Chastetree | Vitex | Vitex agnus
Walnut	Juglans regia	Juglans regia | Walnut
Water hyssop	Bacopa monnieri	Bacopa | Bacopa monnieri | Moneywort | Water hyssop
Watermelon	Citrullus lanatus	Citrullus lanatus | Watermelon
Wax-dolls	Fumaria officinalis	Common fumitory | Fumaria officinalis | Fumitory | Wax-dolls
Wax-myrtle	Morella cerifera	Bayberry | Candleberry | Morella cerifera | Southern bayberry | Southern wax-myrtle | Waxberry | Wax-myrtle
West Indian yellowwood	Zanthoxylum clava	Hercules'-club | Pepperbark | Southern prickly-ash | West Indian yellowwood | Zanthoxylum clava
Wheat grass	Triticum aestivum	Bread wheat | Triticum aestivum | Wheat | Wheat grass | Xiao mai
White Atractylodes	Atractylodes macrocephala	Atractylodes macrocephala | Bai zhu | Bai zhu atractylodes | Largehead Atractylodes | White Atractylodes
White lily	Lilium candidum	Lilium candidum | Madonna lily | White lily
White oak	Quercus alba	Quercus alba | Stave oak | White oak
White pepper	Piper nigrum	Black pepper | Pepper- black | Pepper- white | Piper nigrum | White pepper
White sassafras	Sassafras albidum	Common sassafras | Sassafras | Sassafras albidum | White sassafras
Wild geranium	Geranium maculatum	Cranesbill | Geranium maculatum | Spotted geranium | Wild geranium
Wild radish	Raphanus raphanistrum	Jointed charlock | Raphanus raphanistrum | Wild radish
Wild yam	Dioscorea villosa	Chinaroot | Dioscorea villosa | Wild yam
Winter savory	Satureja montana	Satureja montana | Savory | Winter savory
Witch-hazel	Hamamelis virginiana	Hamamelis | Hamamelis virginiana | Spotted alder | Winter bloom | Witchazel | Witch-hazel
Wood betony	Stachys officinalis	Bishop's-wort | Purple betony | Stachys officinalis | Wood betony
Woodland hawthorn	Crataegus laevigata	Crataegus laevigata | English hawthorn | Hawthorn | Maytree | Two-style hawthorn | Whitethorn | Woodland hawthorn
Wood spider	Harpagophytum procumbens	Devil's-claw | Grapple plant | Harpagophytum procumbens | Wood spider
Wormwood	Artemisia absinthium	Absinthe | Absinthe wormwood | Absinthium | Artemisia absinthium | Wormwood
Wu hua guo	Ficus carica	Ficus carica | Fig | Fig tree | Wu hua guo
Wu wei zi	Schisandra chinensis	Chinese Magnoliavine | Schisandra | Schisandra chinensis | Wu wei zi
Xiakucao	Prunella vulgaris	Common selfheal | Heal-all | Prunella | Prunella vulgaris | Self-heal | Woundwort | Xiakucao
Xiang fu zi	Cyperus rotundus	Coco-grass | Cyperus rotundus | Nut-grass | Nutgrass | Nutgrass alingale | Nut sedge | Purple nut sedge | Red nut sedge | Suo cao | Xiangfu | Xiang fu zi
Xiao Fan Tian Hua	Urena lobata	Di Tao Hua | Urena lobata | Xiao Fan Tian Hua
Xing	Prunus armeniaca	Apricot | Prunus armeniaca | Siberian apricot | Xing
Xuan guo wen zi cao	Filipendula ulmaria	Dropwort | Filipendula ulmaria | Meadowsweet | Queen-of-the-meadow | Xuan guo wen zi cao
Yarrow	Achillea millefolium	Achillea millefolium | Common yarrow | Milfoil | Yarrow
Yawroot	Stillingia sylvatica	Queen's-delight | Queen's-root | Stillingia | Stillingia sylvatica | Yawroot
Yellow bedstraw	Galium verum	Galium verum | Lady's bedstraw | Yellow bedstraw
Yellow chasteweed	Helichrysum arenarium	Everlasting | Helichrysum arenarium | Immortelle | Sandy everlasting | Yellow chasteweed
Yellow dock	Rumex crispus	Curly dock | Rumex crispus | Sour dock | Yellow dock
Yellow gentian	Gentiana lutea	Bitterwort | Gentian | Gentiana lutea | Gentian-root | Yellow gentian
Yellow root	Hydrastis canadensis	Goldenseal | Hydrastis canadensis | Orangeroot | Yellow-puccoon | Yellow root
Yerba mate	Ilex paraguariensis	Brazilian tea | Ilex paraguariensis | Mate | Paraguayan tea | Paraguay tea | St Bartholomew's tea | Yerba mate
Yerba-santa	Eriodictyon californicum	Eriodictyon californicum | Mountain balm | Yerba-santa
Yin yang huo	Epimedium grandif	Barrenwort | Epimedium grandif | Epimedium grandiflorum | Horny goat weed | Japanese epimedium | Yin yang huo
Yin yang huo	Epimedium grandiflorum	Barrenwort | Epimedium grandif | Epimedium grandiflorum | Horny goat weed | Japanese epimedium | Yin yang huo
Yohimbe	Pausinystalia johimbe	Pausinystalia johimbe | Yohimbe
Yucca	Yucca filamentosa	Adam's-needle | Bear-grass | Needle-palm | Spoon-leaf yucca | Yucca | Yucca filamentosa
Yunzhi	Trametes versicolor	Kawaratake | Trametes versicolor | Turkey Tail | Yunzhi
zang bian da huang	Rheum	Himalayan rhubarb | Himalaya-Rhabarber | Indian rhubarb | Rheum | Rheum australe | zang bian da huang
zang bian da huang	Rheum australe	Himalayan rhubarb | Himalaya-Rhabarber | Indian rhubarb | Rheum | Rheum australe | zang bian da huang
Zhangguogancao	Glycyrrhiza inflata	Glycyrrhiza inflata | Licorice | Zhangguogancao
Zhang ye da huang	Rheum palmatum	Chinese Rhubarb | Ornamental rhubarb | Rheum palmatum | Rhubarb | Zhang ye da huang
Zhu sha gen	Ardisia crenata	Ardisia crenata | Coralberry | Coralberry tree | Coral bush | Hen's-eyes | Koraalbessieboom | Spiceberry | Zhu sha gen
